33 -1 35 -1 11 37 -1 -1
-1 -1 -1 10 -1 -1 -1 39
34 -1 9 -1 32 -1 38 -1
-1 -1 8 -1 -1 31 -1 -1
0 3 5 12 14 26 29 30
-1 -1 -1 13 -1 -1 -1 -1
-1 -1 16 15 21 22 23 -1
20 19 -1 17 -1 -1 -1 36
-1 -1 24 -1 25 -1 28 -1